atlet|atlit
balsam|balsem
cendekiawan|cendikiawan
ekspor|eksport
ekstra|extra
frekuensi|frekwensi
frustrasi|frustasi
gua|goa
ijazah|ijasah
jadwal|jadual
jenazah|jenasah
kamuflase|kamuplase
karier|karir
konferensi|konperensi
kongres|konggres
merek|merk
meterai|meterei
miliar|milyar
misi|missi
mubazir|mubadir
paspor|pasport
praktik|praktek
sentral|central
subjek|subyek
subjektif|subyektif
surga|sorga
teknik|tehnik
abjad|abjat
advokat|adpokat
akhir|ahir
aktif|aktip
aktivitas|aktifitas
al quran|alquran
analisis|analisa
andal|handal
antre|antri
apotek|apotik
asam|asem
asas|azas
ateis|atheis
atlet|atlit
atmosfer|atmosfir
baut|baud
bengkuang|bengkoang
berandal|brandal
besok|esok
bewok|brewok
bosan|bosen
brankas|brangkas
bungkuk|bongkok
bus|bis
cabai|cabe
capai|capek
cedera|cidera
cenderamata|cinderamata
cengkeram|cengkrama
cengkih|cengkeh
cokelat|coklat
comro|combro
daftar|daptar
debit|debet
definisi|definisi
definisi|difinisi
depot|depo
detail|detil
diagnosis|diagnosa
diesel|disel
diferensial|differensial
dipersilakan|dipersilahkan
dipindahkan|dipindah
disahkan|disyahkan
dolar|dollar
durian|duren
ekspor|eksport
ekstrem|ekstrim
ekuivalen|ekwivalen
embus|hembus
esai|esei
esai|essay
februari|pebruari
film|filem
fiologi|phiologi
fisik|phisik
fondasi|pondasi
formal|formil
foto|photo
fotokopi|foto copy
frasa|frase
frekuensi|frekwensi
gaib|ghoib
galeri|galleri
geladibersih|geladiresik
genting|genteng
gerogol|grogol
gizi|gisi
gladi|geladi
gua|goa
gudek|gudeg
guncang|goncang
hafal|hapal
hakikat|hakekat
hierarki|hiraki
hierarki|hirarki
hijau|ijo
hipotesis|hipotesa
hipotesis|hipotesia
ibukota|ibu kota
ijazah|ijasah
ikhlas|ihlas
ilmuwan|ilmiawan
ilusi|illusi
imbau|himbau
impor|import
indera|indra
indragiri|inderagiri
infus|inpus
insaf|insyaf
isap|hisap
istri|isteri
izin|ijin
jadwal|jadual
jagat|jagad
jajar|jejer
jamaah|jemaat
jenazah|jenasah
jenderal|jendral
junior|yunior
justru|justeru
kacamata|kecamata
kadaluarsa|kedaluwarsa
kaidah|kaedah
kanker|kangker
kantong|kantung
kardus|kerdus
karier|karir
kategori|katagori
katolik|katholik
kaus|kaos
kecoak|kacoak
kecoak|kacuak
kecoak|kecoa
kedaluwarsa|daluwarsa
kedaluwarsa|kadaluwarsa
kedelai|kedele
kempis|kempes
kendaraan|kenderaan
kendur|kendor
keram|kram
khotbah|khutbah
knalpot|kenalpot
koboi|koboy
komoditi|komoditas
kompleks|komplek
komplet|komplit
konduite|kondite
konferesi|konperensi
konkret|kongkrit
konkret|konkrit
konsepsional|konsepsionil
koordinasi|koordinir
kosa kata|kosakata
kreativitas|kreatiftas
kualifikasi|kwalifikasi
kualitas|kwalitas
kualitas|kwalitet
kualitatif|kwalitatif
kuantitas|kwantitas
kuantitatif|kwantitatif
kuitansi|kwitansi
kuno|kuna
lokakarya|loka karya
lubang|lobang
maaf|ma'af
maaf|maâ€™af
mabuk|mabok
magnet|mahnet
makhluk|mahluk
mampat|mampet
manajemen|managemen
manajer|manager
mangkuk|mangkok
masjid|mesjid
matahari|mentari
mazhab|mahzab
memproklamasikan|memproklamirkan
mencolok|menyolok
mendefinisikan|mendifinisikan
menerapkan|menterapkan
menerjemahkan|menterjemahkan
mengelola|melola
mengesampingkan|mengenyampingkan
mengkritik|mengeritik
mengubah|mengobah
mengubah|merubah
menyukseskan|mensukseskan
mesti|musti
metode|metoda
modern|moderen
motif|motip
motivasi|motifasi
mulia|mulya
mungkir|pungkir
musafir|musyafir
museum|musium
naas|nahas
nakhoda|nahkoda
napas|nafas
narasumber|nara sumber
nasihat|nasehat
negatif|negatip
negeri|negri
negosiasi|negoisasi
nomor|nomer
notula|notulen
november|nopember
objek|obyek
objektif|obyektif
objektif|obyektip
olahraga|olah raga
ons|on
orang tua|orangtua
paham|faham
pedas|pedes
peduli|perduli
pelepasan|penglepasan
peletakan|perletakan
penasihat|penasehat
penggawa|punggawa
penglihatan|pengliatan
pensil|pinsil
permukiman|pemukiman
persen|prosen
persentase|prosentase
perumahan|prumahan
pikir|fikir
praktik|praktek
prancis|perancis
problematic|problimatik
produktivitas|produktifitas
provinsi|propinsi
psikotes|psikotest
pusing|pening
putra|putera
putri|puteri
rabu|rebo
rapi|rapih
realitas|realita
rezeki|rejeki
risiko|resiko
roboh|rubuh
ruh|roh
sah|syah
sahdu|syahdu
sakelar|saklar
saksama|seksama
sambal|sambel
samudra|samudera
saraf|sarap
saraf|syaraf
satai|sate
saus|saos
segitiga|segi tiga
sekadar|sekedar
sekretaris|sekertaris
sekuriti|sekuritas
selagi|mumpung
selebritas|selebriti
senin|senen
sepak bola|sepakbola
silakan|silahkan
sintesis|sintesa
sistem|sistim
sistematis|sistimatis
sopir|supir
spanduk|sepanduk
spesies|spesis
standar|standard
standardisasi|standarisasi
stasiun|setasiun
subjek|subyek
subjektif|subyektif
subjektif|subyektip
sumatra|sumatera
surga|syurga
survei|survai
sutera|sutra
syukur|sukur
tafsiran|tapsiran
tahta|takhta
takhta|tahta
tampak|nampak
tanda tangan|tandatangan
tangkap|tangkep
tarif|tarip
tekad|tekat
teknik|tehnik
teknologi|tehnologi
teladan|tauladan
telanjur|terlanjur
telantar|terlantar
telentang|terlentang
telepon|telefon
telepon|telfon
telepon|telpon
telepon|tilpon
telepon|tilpun
telur|telor
tenteram|tentram
teoretis|teoritis
terampil|trampil
tim|team
tobat|taubat
tradisional|tradisionil
trotoar|trotoir
ubah|rubah
utang|hutang
vaksinasi|faksinasi
varietas|varitas
vila|villa
wakaf|waqaf
wali kota|walikota
wasalam|wasallam
wujud|ujud
yogyakarta|jogjakarta
yudikatif|yudikatip
zaman|jaman
zona|zone
