bakul	NN/NND
batang	NN/NND
belah	NN/NND/VB
bentuk	NN/NND
berkas	NN/NND
bidang	NN/NND
biji	NN/NND
bilah	NN/NND/VB
bongkah	NN/NND
botol	NN/NND
buah	NN/NND
buku	NN/NND
bulir	NN/NND
bungkal	NN/NND
bungkus	NN/NND
butir	NN/NND
caping	NN/NND
carik	NN/NND/JJ
cawan	NN/NND
cekak	NN/NND/VB
cupak	NN/NND
depa	NN/NND
dulang	NN/NND/VB
ekor	NN/NND
galah	NN/NND
gantang	NN/NND
gelas	NN/NND
geluk	NN/NND
genggam	NN/NND
goni	NN/NND
guci	NN/NND
gugus	NN/NND
gumpal	NN/NND
hasta	NN/NND
helai	NN/NND
ikat	NN/NND
iris	NN/NND
jaras	NN/NND
jengkal	NN/NND
jenis	NN/NND
kaki	NN/NND
kapur	NN/NND
karung	NN/NND
kawan	NN/NND
kecap	NN/NND
kecup	NN/NND/VB
kepal	NN/NND
keping	NN/NND
kerat	NN/NND
kuntum	NN/NND
langkah	NN/NND
laras	NN/NND/JJ
lembar	NN/NND
macam	NN/NND
onggok	NN/NND
orang	NN/NND
papan	NN/NND
pasang	NN/NND/VB
pasu	NN/NND
patah	NND/JJ
pikul	NN/NND
piring	NN/NND
potong	NN/NND/VB
pucuk	NN/NND
puntung	NN/NND
rencengan	NN/NND
rombongan	NN/NND
ruas	NN/NND
rumpun	NN/NND
sendok	NN/NND
sikat	NN/NND/VB
sisir	NN/NND/VB
suap	NN/NND
tandan	NN/NND
tangkai	NN/NND
tapak	NN/NND
teguk	NN/NND/VB/JJ
teras	NN/NND
tetes	NN/NND
timbun	NN/NND
titik	NN/NND
truk	NN/NND
tudung	NN/NND
tumpuk	NN/NND/VB
tusuk	NN/NND/VB
unggun	NN/NND
untai	NN/NND
utas	NN/NND/JJ
